ZÃ¼rich	/travel/travel_destination/climate./travel/travel_destination_monthly_climate/month	October
Autoharp	/music/performance_role/regular_performances./music/group_membership/group	Heart
Winnie_the_Pooh	/film/film/release_date_s./film/film_regional_release_date/film_release_region	France
England	/location/location/contains	Pontefract
England	/location/location/contains	Lancaster
Brad_Dourif	/film/actor/film./film/performance/film	Bad_Lieutenant:_Port_of_Call_New_Orleans
MTV_Movie_Award_for_Best_Scared-As-S**t_Performance	/award/award_category/nominees./award/award_nomination/nominated_for	Piranha_3D
Prime_minister-GB	/government/government_office_category/officeholders./government/government_position_held/jurisdiction_of_office	Liechtenstein
The_Last_King_of_Scotland	/film/film/genre	War_film
Kasper_Schmeichel	/sports/pro_athlete/teams./sports/sports_team_roster/team	Notts_County_F.C.
Restless	/film/film/release_date_s./film/film_regional_release_date/film_release_region	Argentina
Florence	/base/popstra/location/vacationers./base/popstra/vacation_choice/vacationer	David_Henrie
Bohemia	/olympics/olympic_participating_country/medals_won./olympics/olympic_medal_honor/medal	Bronze_medal
Asheville	/location/location/time_zones	Eastern_Time_Zone
David_Cross	/people/person/places_lived./people/place_lived/location	Florida
Seattle_Seahawks	/sports/sports_team/colors	Blue
Lycoming_County	/location/statistical_region/rent50_2./measurement_unit/dated_money_value/currency	United_States_Dollar
58th_Academy_Awards	/award/award_ceremony/awards_presented./award/award_honor/honored_for	Kiss_of_the_Spider_Woman
2008_Summer_Olympics	/olympics/olympic_games/participating_countries	Djibouti
2008_Summer_Olympics	/olympics/olympic_games/participating_countries	Mauritania
Northwestern_University	/education/educational_institution/students_graduates./education/education/major_field_of_study	Computer_Science
Virginia	/location/statistical_region/religions./location/religion_percentage/religion	Presbyterianism
War_on_Terrorism	/military/military_conflict/combatants./military/military_combatant_group/combatants	Canada
Grammy_Award_for_Best_Country_Album	/award/award_category/winners./award/award_honor/ceremony	43rd_Annual_Grammy_Awards
Grammy_Award_for_Best_Country_Album	/award/award_category/winners./award/award_honor/ceremony	42nd_Annual_Grammy_Awards
Christianity	/user/tsegaran/random/taxonomy_subject/entry./user/tsegaran/random/taxonomy_entry/taxonomy	Library_of_Congress_Classification
Artie_Lange	/influence/influence_node/influenced_by	Jackie_Gleason
Detective_Dee:_Mystery_of_the_Phantom_Flame	/film/film/release_date_s./film/film_regional_release_date/film_release_region	United_Kingdom
Carl_Foreman	/people/person/place_of_birth	Chicago
Traffic_collision	/people/cause_of_death/people	Albert_Camus
Marquette_University	/education/educational_institution/school_type	Society_of_Jesus-GB
Acadia_University	/education/educational_institution/students_graduates./education/education/major_field_of_study	Chemistry
Charlie's_Angels:_Full_Throttle	/film/film/prequel	Charlie's_Angels
Screen_Actors_Guild_Award_for_Outstanding_Performance_by_a_Male_Actor_in_a_Supporting_Role	/award/award_category/nominees./award/award_nomination/nominated_for	The_King's_Speech
Screen_Actors_Guild_Award_for_Outstanding_Performance_by_a_Male_Actor_in_a_Supporting_Role	/award/award_category/nominees./award/award_nomination/nominated_for	As_Good_as_It_Gets
Dean_Koontz	/people/person/profession	Film_Producer-GB
20th_Century_Fox	/film/film_distributor/films_distributed./film/film_film_distributor_relationship/film	Star_Wars_Episode_IV:_A_New_Hope
20th_Century_Fox	/film/film_distributor/films_distributed./film/film_film_distributor_relationship/film	Monty_Python_and_the_Holy_Grail
20th_Century_Fox	/award/award_nominee/award_nominations./award/award_nomination/award_nominee	DreamWorks
Tom_Werner	/tv/tv_producer/programs_produced./tv/tv_producer_term/producer_type	Executive_Producer
The_Beaver	/film/film/release_date_s./film/film_regional_release_date/film_release_region	Brazil
Victor_Victoria	/film/film/edited_by	Ralph_E._Winters
St._Louis_Rams	/sports/sports_team/sport	American_football
African_American	/people/ethnicity/people	John_Lee_Hooker
African_American	/people/ethnicity/people	Kenan_Thompson
Lincoln	/film/film/estimated_budget./measurement_unit/dated_money_value/currency	United_States_Dollar
Bret_Michaels	/people/person/profession	Musician-GB
Belgium	/organization/organization_member/member_of./organization/organization_membership/organization	League_of_Nations
Peter_Graves	/people/deceased_person/place_of_death	Pacific_Palisades
United_Artists	/film/film_distributor/films_distributed./film/film_film_distributor_relationship/film	You_Only_Live_Twice
Satellite_Award_for_Best_Costume_Design	/award/award_category/nominees./award/award_nomination/nominated_for	Nine
The_Expendables	/film/film/executive_produced_by	Boaz_Davidson
Decca_Records	/music/record_label/artist	Nat_King_Cole
Bill_Cosby	/award/award_nominee/award_nominations./award/award_nomination/award	Primetime_Emmy_Award_for_Outstanding_Lead_Actor_-_Drama_Series
Swoosie_Kurtz	/film/actor/film./film/performance/film	Dangerous_Liaisons
Cleopatra	/film/film/featured_film_locations	Rome
Gangs_of_New_York	/film/film/film_festivals	2010_Berlin_International_Film_Festival
John_Ruddy	/people/person/gender	Male
Vampire_Knight	/tv/tv_program/regular_cast./tv/regular_tv_appearance/actor	Jun_Fukuyama
Texas	/location/location/contains	Garland
Guy_Ritchie	/people/person/profession	Film_Producer-GB
Kenneth_Branagh	/film/director/film	Thor
Nas	/award/award_nominee/award_nominations./award/award_nomination/award	Grammy_Award_for_Best_Rap_Album
The_Unbearable_Lightness_of_Being	/award/award_winning_work/awards_won./award/award_honor/award_winner	Sven_Nykvist
Grammy_Award_for_Best_Female_Rock_Vocal_Performance	/award/award_category/winners./award/award_honor/ceremony	44th_Annual_Grammy_Awards
Producers_Guild_of_America_Award_for_Best_Theatrical_Motion_Picture	/award/award_category/nominees./award/award_nomination/nominated_for	Invictus
Ocean's_Twelve	/film/film/language	Italian_Language
Long_Island_University	/organization/non_profit_organization/registered_with./organization/non_profit_registration/registering_agency	Internal_Revenue_Service
Drew_Barrymore	/film/actor/film./film/performance/film	Confessions_of_a_Dangerous_Mind
Hans_Christian_Andersen	/people/person/profession	Poet
Academy_Award_for_Best_Sound_Mixing	/award/award_category/nominees./award/award_nomination/nominated_for	Fame
Glitch	/music/genre/parent_genre	Intelligent_dance_music
25th_United_States_Congress	/government/legislative_session/members./government/government_position_held/district_represented	Arkansas
Magic_Mike	/film/film/release_date_s./film/film_regional_release_date/film_release_region	United_Kingdom
Egg	/food/food/nutrients./food/nutrition_fact/nutrient	Pantothenic_acid
Egg	/food/food/nutrients./food/nutrition_fact/nutrient	Beta-carotene
William_Shatner	/film/actor/film./film/performance/film	DodgeBall:_A_True_Underdog_Story
Bachelor_of_Arts	/education/educational_degree/people_with_this_degree./education/education/institution	Royal_Holloway,_University_of_London
Smokin'_Aces	/film/film/production_companies	StudioCanal
Daniel_Day-Lewis	/people/person/spouse_s./people/marriage/type_of_union	Domestic_partnership
Robbie_Coltrane	/film/actor/film./film/performance/film	Henry_V
Carleton_College	/education/educational_institution/students_graduates./education/education/student	E._G._Marshall
Flo_Rida	/people/person/profession	Artist-GB
Ian_Bannen	/award/award_nominee/award_nominations./award/award_nomination/award	Screen_Actors_Guild_Award_for_Outstanding_Performance_by_a_Cast_in_a_Motion_Picture
James_LeGros	/film/actor/film./film/performance/film	Drugstore_Cowboy
Gloria_Estefan	/people/person/profession	Singer-songwriter-GB
2012_British_Academy_Film_Awards	/award/award_ceremony/awards_presented./award/award_honor/award_winner	Meryl_Streep
Rock_music	/music/genre/artists	Dio
David_J	/people/person/nationality	United_Kingdom
David_J	/music/artist/track_contributions./music/track_contribution/role	Kazoo
Kings_of_Leon	/influence/influence_node/influenced_by	Queens_of_the_Stone_Age
Vickers-Armstrongs	/organization/organization/headquarters./location/mailing_address/citytown	Westminster
UEFA	/sports/sports_league/teams./sports/sports_league_participation/team	Finland_national_football_team
Richard_Nixon	/organization/organization_founder/organizations_founded	NASA
Celine_Dion	/award/award_nominee/award_nominations./award/award_nomination/award	MTV_Video_Music_Award_for_Best_Video_from_a_Film
Celine_Dion	/award/award_nominee/award_nominations./award/award_nomination/award	MTV_Movie_Award_for_Best_Song_from_a_Movie
Florida	/location/location/time_zones	Eastern_Time_Zone
Florida	/location/statistical_region/religions./location/religion_percentage/religion	Nondenominational_Christianity
Barrie	/common/topic/webpage./common/webpage/category	Official_Website
Broadcast_Film_Critics_Association_Award_for_Best_Film	/award/award_category/nominees./award/award_nomination/nominated_for	The_Pianist
Contact	/film/film/language	English_Language
H._P._Lovecraft	/influence/influence_node/influenced_by	H._G._Wells
To_Kill_a_Mockingbird	/film/film/release_date_s./film/film_regional_release_date/film_release_region	Austria
Crewe	/sports/sports_team_location/teams	Crewe_Alexandra_F.C.
Rickey_Henderson	/sports/pro_athlete/teams./sports/sports_team_roster/team	Los_Angeles_Dodgers
University_of_Karachi	/education/educational_institution/campuses	University_of_Karachi
Terry_Crews	/people/person/nationality	United_States_of_America
Anna_Karenina	/film/film/story_by	Leo_Tolstoy
Auckland	/base/biblioness/bibs_location/country	New_Zealand
Beck_Hansen	/award/award_nominee/award_nominations./award/award_nomination/award	MTV_Movie_Award_for_Best_Song_from_a_Movie
Boston_University_School_of_Law	/education/university/domestic_tuition./measurement_unit/dated_money_value/currency	United_States_Dollar
Amazon.com	/base/schemastaging/organization_extra/phone_number./base/schemastaging/phone_sandbox/service_language	English_Language
Socialist_Federal_Republic_of_Yugoslavia	/olympics/olympic_participating_country/athletes./olympics/olympic_athlete_affiliation/olympics	1988_Summer_Olympics
Law_degree	/education/educational_degree/people_with_this_degree./education/education/institution	University_of_Michigan_Law_School
Robert_Morley	/people/person/gender	Male
University_of_British_Columbia	/education/educational_institution/school_type	University
William_H._Macy	/people/person/nationality	United_States_of_America
Atlanta	/base/petbreeds/city_with_dogs/top_breeds./base/petbreeds/dog_city_relationship/dog_breed	German_Shepherd_Dog
Abdominal_pain	/medicine/symptom/symptom_of	Typhoid_fever
Eclipse	/film/film/other_crew./film/film_crew_gig/film_crew_role	Art_Director
Morgan_Freeman	/people/person/nationality	United_States_of_America
Turkey	/organization/organization_member/member_of./organization/organization_membership/organization	United_Nations
Keyboard	/music/instrument/instrumentalists	Yanni
Master_of_Science	/education/educational_degree/people_with_this_degree./education/education/student	Carl_Sagan
British_Broadcasting_Corporation	/base/schemastaging/organization_extra/phone_number./base/schemastaging/phone_sandbox/service_location	United_Kingdom
Gene_Reynolds	/film/actor/film./film/performance/film	The_Country_Girl
Candice_Bergen	/award/award_nominee/award_nominations./award/award_nomination/award	Academy_Award_for_Best_Actress_in_a_Supporting_Role
University_of_Notre_Dame	/common/topic/webpage./common/webpage/category	Official_Website
John_Dingell	/government/politician/government_positions_held./government/government_position_held/legislative_sessions	109th_United_States_Congress
Blues-rock	/music/genre/artists	John_Lennon
Blues-rock	/music/genre/artists	Danzig
Marvin_Hatley	/people/deceased_person/place_of_death	Hollywood
David_Spade	/people/person/nationality	United_States_of_America
Kenny_Rogers	/people/person/profession	Photographer
Placer_County	/location/location/adjoin_s./location/adjoining_relationship/adjoins	El_Dorado_County
David_Lean	/award/award_nominee/award_nominations./award/award_nomination/award	BAFTA_Award_for_Best_Direction
Hong_Kong_Film_Award_for_Best_Supporting_Actor	/award/award_category/nominees./award/award_nomination/nominated_for	A_Simple_Life
Bachelor_of_Science	/education/educational_degree/people_with_this_degree./education/education/institution	State_University_of_New_York_at_Stony_Brook
Ellen_Page	/people/person/place_of_birth	Halifax_Regional_Municipality
Danny_Kaye	/people/person/spouse_s./people/marriage/type_of_union	Marriage
The_Smurfs	/film/film/release_date_s./film/film_regional_release_date/film_release_region	Germany
Emanuel_Azenberg	/people/person/profession	Theatrical_producer
The_City_of_Lost_Children	/film/film/other_crew./film/film_crew_gig/film_crew_role	Special_Effects
The_City_of_Lost_Children	/film/film/release_date_s./film/film_regional_release_date/film_release_region	Switzerland
British_people	/people/ethnicity/languages_spoken	Welsh_Language
British_people	/people/ethnicity/people	Shirley_Ann_Russell
Loyola_University_Chicago	/education/educational_institution/students_graduates./education/education/major_field_of_study	Business
Keith_Carradine	/people/person/place_of_birth	San_Mateo
Boxing	/olympics/olympic_sport/athletes./olympics/olympic_athlete_affiliation/country	Serbia
Boxing	/olympics/olympic_sport/athletes./olympics/olympic_athlete_affiliation/country	Cambodia
University_of_Delaware	/education/university/fraternities_and_sororities	Alpha_Delta_Pi
Howards_End	/film/film/film_format	Super_35
Screen_Actors_Guild_Life_Achievement_Award	/award/award_category/winners./award/award_honor/award_winner	Barbara_Stanwyck
Academy_Award_for_Best_Director	/award/award_category/nominees./award/award_nomination/nominated_for	Women_in_Love
Academy_Award_for_Best_Director	/award/award_category/nominees./award/award_nomination/nominated_for	The_Last_Picture_Show
Carlos_Santana	/music/artist/track_contributions./music/track_contribution/role	Bell
James_Taylor	/people/person/profession	Actor-GB
Bela_Lugosi	/film/actor/film./film/performance/special_performance_type	Cameo_appearance
Western_Michigan_University	/education/educational_institution/students_graduates./education/education/major_field_of_study	Computer_Science
Martin_Short	/people/person/profession	Voice_Actor
Academy_Award_for_Best_Production_Design	/award/award_category/winners./award/award_honor/ceremony	58th_Academy_Awards
Free_University_of_Berlin	/education/educational_institution/students_graduates./education/education/major_field_of_study	Physics
Los_Angeles	/location/location/contains	Beverly_Hills
Sandra_Bernhard	/people/person/profession	Actor-GB
Alfred_Hitchcock	/people/person/nationality	England
Writers_Guild_of_America_Award_for_Best_Adapted_Screenplay	/award/award_category/nominees./award/award_nomination/nominated_for	The_Birdcage
Judi_Dench	/people/person/place_of_birth	York
Sean_Combs	/people/person/places_lived./people/place_lived/location	Long_Island
Allen_Covert	/film/actor/film./film/performance/film	Jack_&_Jill
Algeria	/olympics/olympic_participating_country/athletes./olympics/olympic_athlete_affiliation/olympics	2004_Summer_Olympics
Aliens	/film/film/genre	Action_Film
Fran_Walsh	/people/person/nationality	New_Zealand
Inception	/film/film/release_date_s./film/film_regional_release_date/film_release_region	Denmark-GB
Clive_Owen	/award/award_nominee/award_nominations./award/award_nomination/award_nominee	Kelly_Macdonald
Pearl_Harbor	/film/film/language	Japanese_Language
Bandai	/business/business_operation/industry	Video_game
Anchorman:_The_Legend_of_Ron_Burgundy	/film/film/executive_produced_by	David_O._Russell
Interscope_Records	/music/record_label/artist	John_5
Cyprus	/organization/organization_member/member_of./organization/organization_membership/organization	United_Nations
Vinod_Khanna	/people/person/languages	Punjabi_language
University_of_Arizona	/education/educational_institution/students_graduates./education/education/student	Jerry_Bruckheimer
The_King's_Speech	/award/award_winning_work/awards_won./award/award_honor/award_winner	Helena_Bonham_Carter
Ashkenazi_Jews	/people/ethnicity/people	Tony_Curtis
The_Painted_Veil	/film/film/language	French_Language
Frank_Capra	/people/person/nationality	United_States_of_America
Walter_M._Scott	/film/film_set_designer/film_sets_designed	Peyton_Place
Emma_Stone	/film/actor/film./film/performance/film	Marmaduke
MTV_Movie_Award_for_Best_Movie	/award/award_category/nominees./award/award_nomination/nominated_for	The_Truman_Show
Modern_pentathlon	/olympics/olympic_sport/athletes./olympics/olympic_athlete_affiliation/country	Bulgaria
Colbie_Caillat	/award/award_nominee/award_nominations./award/award_nomination/award	Grammy_Award_for_Best_Pop_Vocal_Album
Basic_Instinct_2	/film/film/estimated_budget./measurement_unit/dated_money_value/currency	United_States_Dollar
Philadelphia_Phillies	/sports/professional_sports_team/draft_picks./sports/sports_league_draft_pick/draft	1995_Major_League_Baseball_Draft
University_of_Texas_at_Austin	/education/educational_institution/students_graduates./education/education/major_field_of_study	Art
Alec_Baldwin	/base/schemastaging/person_extra/net_worth./measurement_unit/dated_money_value/currency	United_States_Dollar
Minority_Report	/film/film/featured_film_locations	Washington,_D.C.
BAFTA_Award_for_Best_Direction	/award/award_category/nominees./award/award_nomination/nominated_for	Capote
Joseph_Fiennes	/people/person/spouse_s./people/marriage/location_of_ceremony	Tuscany
University_of_Kansas	/education/educational_institution/colors	Crimson
Curly_Howard	/people/person/profession	Actor-GB
Tommy_Lee_Jones	/film/actor/film./film/performance/film	Space_Cowboys
Dorothy_Fields	/people/person/profession	Lyricist
Michelle_Rodriguez	/people/person/places_lived./people/place_lived/location	Dominican_Republic
Primetime_Emmy_Award_for_Outstanding_Supporting_Actress_-_Drama_Series	/award/award_category/winners./award/award_honor/ceremony	56th_Primetime_Emmy_Awards
Angela_Kinsey	/people/person/languages	English_Language
David_Simon	/tv/tv_producer/programs_produced./tv/tv_producer_term/producer_type	Executive_Producer
8_Mile	/film/film/other_crew./film/film_crew_gig/film_crew_role	Makeup_Artist-GB
Stanley_Kubrick	/award/award_nominee/award_nominations./award/award_nomination/award	Golden_Globe_Award_for_Best_Director_-_Motion_Picture
Columbia_Pictures	/film/film_distributor/films_distributed./film/film_film_distributor_relationship/film	The_King's_Speech
Columbia_Pictures	/film/film_distributor/films_distributed./film/film_film_distributor_relationship/film	Men_in_Black
The_Namesake	/film/film/featured_film_locations	Kolkata
BAFTA_Award_for_Best_Makeup_&_Hair	/award/award_category/nominees./award/award_nomination/nominated_for	Hugo
Harmonica	/music/instrument/instrumentalists	Greg_Graffin
107th_United_States_Congress	/government/legislative_session/members./government/government_position_held/district_represented	Pennsylvania
Don_Siegel	/people/person/spouse_s./people/marriage/type_of_union	Marriage
Saturn_Award_for_Best_Costume	/award/award_category/nominees./award/award_nomination/nominated_for	The_Mask_of_Zorro
1980_Summer_Olympics	/user/jg/default_domain/olympic_games/sports	Rowing
Dyslexia	/medicine/disease/notable_people_with_this_condition	Jay_Leno
Trent_Jones	/people/person/spouse_s./people/marriage/type_of_union	Marriage
Alien	/film/film/release_date_s./film/film_regional_release_date/film_release_region	Philippines
Mamma_Mia!	/film/film/language	Greek_Language
1985_NCAA_Men's_Division_I_Basketball_Tournament	/base/marchmadness/ncaa_basketball_tournament/seeds./base/marchmadness/ncaa_tournament_seed/team	Pittsburgh_Panthers_men's_basketball
Star_Trek	/film/film/other_crew./film/film_crew_gig/film_crew_role	Technical_Director
Amber_Riley	/people/person/profession	Actor-GB
Tyrannosaur	/film/film/release_date_s./film/film_regional_release_date/film_release_region	Portugal
Itzhak_Perlman	/people/person/nationality	Israel
G-Force	/film/film/music	Patrick_Doyle
Calista_Flockhart	/people/person/gender	Female
Ukulele	/music/instrument/instrumentalists	Elvis_Costello
Lesser_Antilles	/location/location/partially_contains	Netherlands
Catwoman	/film/film/other_crew./film/film_crew_gig/film_crew_role	Visual_Effects_Art_Director
Asha_Parekh	/people/person/profession	Television_producer-GB
Emily_Mortimer	/people/person/places_lived./people/place_lived/location	London
Big_Miracle	/film/film/genre	Drama
Axl_Rose	/common/topic/webpage./common/webpage/category	Official_Website
Purdue_University	/education/educational_institution/students_graduates./education/education/major_field_of_study	Finance
The_Trouble_with_Harry	/film/film/film_art_direction_by	Hal_Pereira
Total_Recall	/film/film/release_date_s./film/film_regional_release_date/film_release_region	Thailand
MTV_Video_Music_Award_for_Best_Pop_Video	/award/award_category/winners./award/award_honor/award_winner	P!nk
Michael_Jackson	/people/person/profession	Singer-songwriter-GB
Lauren_Ambrose	/people/person/languages	English_Language
Days_of_Being_Wild	/film/film/language	Mandarin_Chinese
Cars	/film/film/release_date_s./film/film_regional_release_date/film_release_region	Iceland
MTV	/broadcast/content/artist	Prince
San_Diego_Padres	/sports/sports_team/colors	White
How_the_West_Was_Won	/film/film/genre	Action_Film
Piano	/music/instrument/instrumentalists	Roy_Bittan
Academy_Award_for_Best_Original_Screenplay	/award/award_category/nominees./award/award_nomination/nominated_for	North_by_Northwest
Cycling	/olympics/olympic_sport/athletes./olympics/olympic_athlete_affiliation/olympics	1924_Summer_Olympics
Cycling	/olympics/olympic_sport/athletes./olympics/olympic_athlete_affiliation/country	Greece
George_Fenton	/people/person/profession	Composer
Warner_Bros._Records	/music/record_label/artist	James_Ingram
16_Blocks	/film/film/release_date_s./film/film_regional_release_date/film_release_region	Hong_Kong
Cecil_B._DeMille	/people/person/profession	Film_Producer-GB
The_Maltese_Falcon	/film/film/release_date_s./film/film_regional_release_date/film_release_region	Germany
Academy_Award_for_Best_Actress	/award/award_category/nominees./award/award_nomination/nominated_for	Julie_&_Julia
Hip_hop_music	/music/genre/artists	Nas
Mickey_Rourke	/award/award_nominee/award_nominations./award/award_nomination/nominated_for	Iron_Man_2
Road_Trip	/film/film/release_date_s./film/film_regional_release_date/film_release_region	Mexico
X-Men	/film/film/executive_produced_by	Richard_Donner
Carnegie_Mellon_University	/education/university/fraternities_and_sororities	Delta_Delta_Delta
Carol_Kane	/film/actor/film./film/performance/film	The_Muppet_Movie
Auburn	/location/hud_county_place/place	Auburn
Halloween	/film/film/release_date_s./film/film_regional_release_date/film_release_region	Hong_Kong
Master_of_Arts	/education/educational_degree/people_with_this_degree./education/education/institution	University_College_Dublin
Geffen_Records	/music/record_label/artist	Pat_Metheny
The_Pianist	/film/film/release_date_s./film/film_regional_release_date/film_release_region	Israel
War_and_Peace	/film/film/genre	Film_adaptation
Punch-Drunk_Love	/film/film/release_date_s./film/film_regional_release_date/film_release_region	Australia
Boaz_Myhill	/people/person/gender	Male
The_Devil's_Double	/film/film/genre	Biographical_film
The_Devil's_Double	/film/film/release_date_s./film/film_regional_release_date/film_release_region	Portugal
1989_NCAA_Men's_Division_I_Basketball_Tournament	/base/marchmadness/ncaa_basketball_tournament/seeds./base/marchmadness/ncaa_tournament_seed/team	North_Carolina_Tar_Heels_men's_basketball
Lesley_Sharp	/award/award_nominee/award_nominations./award/award_nomination/award	Screen_Actors_Guild_Award_for_Outstanding_Performance_by_a_Cast_in_a_Motion_Picture
The_Conversation	/film/film/film_format	35_mm_film
Planet_of_the_Apes	/film/film/cinematography	Philippe_Rousselot
Academy_Award_for_Best_Short_Film_(Animated)	/award/award_category/winners./award/award_honor/ceremony	60th_Academy_Awards
Tomato	/food/food/nutrients./food/nutrition_fact/nutrient	Linoleic_acid
Bicentennial_Man	/film/film/other_crew./film/film_crew_gig/film_crew_role	Visual_Effects_Art_Director
Primetime_Emmy_Award_for_Outstanding_Lead_Actress_-_Miniseries_or_a_Movie	/award/award_category/winners./award/award_honor/award_winner	Shelley_Winters
Indie_rock	/music/genre/artists	Johnny_Yong_Bosch
Indie_rock	/music/genre/artists	The_Mars_Volta
Indie_rock	/music/genre/artists	The_White_Stripes
Comcast	/base/schemastaging/organization_extra/phone_number./base/schemastaging/phone_sandbox/service_location	United_States_of_America
Comcast	/business/business_operation/industry	Telecommunications
Kandy	/common/topic/webpage./common/webpage/category	Official_Website
Broward_County	/location/hud_foreclosure_area/estimated_number_of_mortgages./measurement_unit/dated_integer/source	United_States_Department_of_Housing_and_Urban_Development
Ry_Cooder	/common/topic/webpage./common/webpage/category	Official_Website
11th_Satellite_Awards	/award/award_ceremony/awards_presented./award/award_honor/award_winner	Eric_Dane
11th_Satellite_Awards	/award/award_ceremony/awards_presented./award/award_honor/award_winner	Martin_Sheen
BAFTA_Award_for_Best_Special_Visual_Effects	/award/award_category/nominees./award/award_nomination/nominated_for	Ghostbusters
The_Rum_Diary	/film/film/music	Christopher_Young
Managing_Director-GB	/organization/role/leaders./organization/leadership/organization	Merck_&_Co.
Managing_Director-GB	/organization/role/leaders./organization/leadership/organization	Northrop_Grumman
Managing_Director-GB	/organization/role/leaders./organization/leadership/organization	TV5
Shooting_sport	/olympics/olympic_sport/athletes./olympics/olympic_athlete_affiliation/country	Vietnam
Shooting_sport	/olympics/olympic_sport/athletes./olympics/olympic_athlete_affiliation/country	United_States_Virgin_Islands
106th_United_States_Congress	/government/legislative_session/members./government/government_position_held/district_represented	Maine
The_Guard	/film/film/language	Irish
Doctorate	/education/educational_degree/people_with_this_degree./education/education/institution	Monash_University
B._J._Novak	/film/actor/film./film/performance/film	The_Smurfs
Cold_Mountain	/film/film/other_crew./film/film_crew_gig/film_crew_role	Art_Director
Million_Dollar_Baby	/film/film/film_production_design_by	Henry_Bumstead
Alfre_Woodard	/people/person/profession	Actor-GB
Alfre_Woodard	/film/actor/film./film/performance/film	Primal_Fear
Carey_Mulligan	/people/person/spouse_s./people/marriage/type_of_union	Marriage
Jaundice	/medicine/symptom/symptom_of	Hepatitis
Red_Tails	/film/film/music	Terence_Blanchard
The_Island	/film/film/featured_film_locations	Los_Angeles
Demi_Lovato	/people/person/place_of_birth	Albuquerque
Demi_Lovato	/people/person/places_lived./people/place_lived/location	Texas
Golden_Globe_Award_for_Best_Director_-_Motion_Picture	/award/award_category/nominees./award/award_nomination/nominated_for	The_Godfather_Part_II
Munich	/film/film/featured_film_locations	Germany
Archery	/olympics/olympic_sport/athletes./olympics/olympic_athlete_affiliation/country	Central_African_Republic
Psycho	/film/film/genre	Slasher
Triathlon	/olympics/olympic_sport/athletes./olympics/olympic_athlete_affiliation/country	Argentina
Road_running	/olympics/olympic_sport/athletes./olympics/olympic_athlete_affiliation/country	Ecuador
Myocardial_infarction	/people/cause_of_death/people	Dick_Clark
Universal_Music_Group	/music/record_label/artist	Iron_Maiden
Quills	/film/film/other_crew./film/film_crew_gig/film_crew_role	Sound_Mixer
Bleach:_Memories_of_Nobody	/film/film/dubbing_performances./film/dubbing_performance/actor	Johnny_Yong_Bosch
15th_Screen_Actors_Guild_Awards	/award/award_ceremony/awards_presented./award/award_honor/honored_for	Mad_Men
Grammy_Award_for_Best_Song_Written_for_a_Motion_Picture,_Television_or_Other_Visual_Media	/award/award_category/winners./award/award_honor/ceremony	36th_Annual_Grammy_Awards
Tim_Allen	/influence/influence_node/influenced_by	Bill_Cosby
Chinese_Civil_War	/film/film_subject/films	The_Sand_Pebbles
George_Benson	/people/person/spouse_s./people/marriage/type_of_union	Marriage
Academy_Award_for_Best_Actor	/award/award_category/nominees./award/award_nomination/nominated_for	The_Shawshank_Redemption
Academy_Award_for_Best_Actor	/award/award_category/nominees./award/award_nomination/nominated_for	Born_on_the_Fourth_of_July
Academy_Award_for_Best_Actor	/award/award_category/nominees./award/award_nomination/nominated_for	127_Hours
Academy_Award_for_Best_Actor	/award/award_category/winners./award/award_honor/ceremony	25th_Academy_Awards
Ray_Allen	/sports/pro_athlete/teams./sports/sports_team_roster/team	Milwaukee_Bucks
The_Nightmare_Before_Christmas	/film/film/language	English_Language
Jack_Huston	/award/award_nominee/award_nominations./award/award_nomination/award_nominee	Shea_Whigham
Rio_de_Janeiro	/sports/sports_team_location/teams	Clube_de_Regatas_Vasco_da_Gama
35th_Canadian_Parliament	/government/legislative_session/members./government/government_position_held/district_represented	Nova_Scotia
Jerry_Nelson	/people/person/nationality	United_States_of_America
Texas_Tech_University	/education/university/fraternities_and_sororities	Alpha_Delta_Pi
Jon_Favreau	/film/actor/film./film/performance/film	Very_Bad_Things
Screen_Actors_Guild_Award_for_Outstanding_Performance_by_a_Cast_in_a_Motion_Picture	/award/award_category/nominees./award/award_nomination/nominated_for	Finding_Neverland
Drums	/music/instrument/instrumentalists	Beck_Hansen
Drums	/music/instrument/instrumentalists	Joshua_Homme
Drums	/music/performance_role/regular_performances./music/group_membership/group	Nick_Cave_and_the_Bad_Seeds
Drums	/music/performance_role/regular_performances./music/group_membership/group	Linkin_Park
Oliver_Twist	/film/film/release_date_s./film/film_regional_release_date/film_release_region	Turkey
Primetime_Emmy_Award_for_Outstanding_Directing_-_Drama_Series	/award/award_category/winners./award/award_honor/ceremony	57th_Primetime_Emmy_Awards
Erwin_Rommel	/people/person/spouse_s./people/marriage/type_of_union	Domestic_partnership
Paraguay	/location/country/form_of_government	Republic
Coming_to_America	/film/film/genre	Romance_Film
Junichi_Inamoto	/soccer/football_player/current_team./sports/sports_team_roster/team	Arsenal_F.C.
Oliver_Hardy	/people/person/nationality	United_States_of_America
A_Bug's_Life	/film/film/production_companies	Walt_Disney_Pictures
Lead_guitar	/music/performance_role/regular_performances./music/group_membership/group	The_Cars
Lead_guitar	/music/performance_role/regular_performances./music/group_membership/group	Grateful_Dead
Tim_Burton	/film/director/film	Dark_Shadows
Indonesia	/base/aareas/schema/administrative_area/administrative_parent	Earth
Michael_Keaton	/people/person/spouse_s./people/marriage/type_of_union	Domestic_partnership
Lead_vocalist-GB	/music/performance_role/regular_performances./music/group_membership/group	Wilco
Anthony_Burgess	/people/person/employment_history./business/employment_tenure/company	British_Army
Emo	/music/genre/artists	Mike_Mogis
Emo	/music/genre/artists	AFI
Ayn_Rand	/award/award_nominee/award_nominations./award/award_nomination/award	National_Book_Award_for_Fiction
Seven_Brides_for_Seven_Brothers	/film/film/country	United_States_of_America
Michael_Piller	/people/person/nationality	United_States_of_America
Sven_Nykvist	/award/award_nominee/award_nominations./award/award_nomination/nominated_for	The_Unbearable_Lightness_of_Being
I_Don't_Know_How_She_Does_It	/film/film/release_date_s./film/film_regional_release_date/film_release_region	Argentina
Halle	/location/statistical_region/religions./location/religion_percentage/religion	Judaism-GB
Kansai_region	/location/location/contains	Osaka_Prefecture
Brentford_F.C.	/soccer/football_team/current_roster./sports/sports_team_roster/position	Goalkeeper
Salma_Hayek	/film/actor/film./film/performance/film	Searching_for_Debra_Winger
Latin_jazz	/music/genre/artists	Pat_Metheny
The_Hunger_Games	/film/film/release_date_s./film/film_regional_release_date/film_release_region	Brazil
New_York_Mets	/baseball/baseball_team/team_stats./baseball/baseball_team_stats/season	2004_Major_League_Baseball_season
De_La_Salle_University-Manila	/common/topic/webpage./common/webpage/category	Official_Website
Bachelor's_degree	/education/educational_degree/people_with_this_degree./education/education/institution	Miami_University
Bachelor's_degree	/education/educational_degree/people_with_this_degree./education/education/institution	Florida_A&M_University
Jack_Bruce	/people/person/nationality	United_Kingdom
Memento	/film/film/release_date_s./film/film_regional_release_date/film_regional_debut_venue	Toronto_International_Film_Festival
Robert_Shaw	/film/actor/film./film/performance/film	Battle_of_Britain
The_Scorpion_King	/film/film/music	John_Debney
Grammy_Award_for_Best_Album_Notes	/award/award_category/winners./award/award_honor/ceremony	51st_Annual_Grammy_Awards-US
Bill_Evans	/people/person/spouse_s./people/marriage/type_of_union	Marriage
1988_Summer_Olympics	/olympics/olympic_games/sports	Archery
Thomas_Lennon	/people/person/profession	Screenwriter
Orange_County	/film/film/other_crew./film/film_crew_gig/film_crew_role	Special_Effects_Supervisor
F._Murray_Abraham	/film/actor/film./film/performance/film	All_the_President's_Men
President	/organization/role/leaders./organization/leadership/organization	Pace_University
President	/organization/role/leaders./organization/leadership/organization	University_of_Memphis
President	/organization/role/leaders./organization/leadership/organization	Trinity_College
Woody_Harrelson	/film/actor/film./film/performance/film	Anger_Management
RoboCop	/film/film/genre	Thriller
Tiffani_Thiessen	/people/person/place_of_birth	Long_Beach
Liberia	/organization/organization_member/member_of./organization/organization_membership/organization	League_of_Nations
Ryan_Murphy	/people/person/place_of_birth	Indianapolis
Sarah_Lawrence_College	/education/educational_institution/school_type	Private_school
New_Wave	/music/genre/parent_genre	Ska
New_Wave	/music/genre/artists	George_Michael
New_Wave	/music/genre/artists	Kelly_Osbourne
Caleb_Deschanel	/people/person/profession	Cinematographer-GB
J._K._Rowling	/people/person/gender	Female
Johnny_Depp	/people/person/nationality	United_States_of_America
Submarine	/common/topic/webpage./common/webpage/category	Official_Website
Master's_Degree	/education/educational_degree/people_with_this_degree./education/education/major_field_of_study	Information_technology
Master's_Degree	/education/educational_degree/people_with_this_degree./education/education/institution	University_of_Calcutta
Sky_Captain_and_the_World_of_Tomorrow	/film/film/other_crew./film/film_crew_gig/crewmember	Dino_De_Laurentiis
Europe	/location/location/contains	Republic_of_Ireland
China	/military/military_combatant/military_conflicts./military/military_combatant_group/combatants	North_Vietnam
Todd_McFarlane	/people/person/profession	Artist-GB
Albert_Brooks	/award/award_nominee/award_nominations./award/award_nomination/award	Independent_Spirit_Award_for_Best_Supporting_Male
Bob_Balaban	/people/person/nationality	United_States_of_America
Grammy_Award_for_Record_of_the_Year	/award/award_category/winners./award/award_honor/ceremony	50th_Annual_Grammy_Awards-US
Charlie_Kaufman	/award/award_nominee/award_nominations./award/award_nomination/award	Independent_Spirit_Award_for_Best_Screenplay
Sex_and_the_City	/film/film/executive_produced_by	Toby_Emmerich
King's_College,_Cambridge	/education/educational_institution/colors	White
Stardust	/film/film/country	United_Kingdom
Stephen_Rea	/people/person/gender	Male
National_Society_of_Film_Critics_Award_for_Best_Actress	/award/award_category/nominees./award/award_nomination/nominated_for	They_Shoot_Horses,_Don't_They?
Merlin	/tv/tv_program/regular_cast./tv/regular_tv_appearance/actor	Isabella_Rossellini
Babylon_5:_The_Gathering	/film/film/distributors./film/film_film_distributor_relationship/film_distribution_medium	VHS
Consultant	/people/profession/specialization_of	Businessperson-GB
Sammo_Hung	/award/award_nominee/award_nominations./award/award_nomination/nominated_for	Detective_Dee:_Mystery_of_the_Phantom_Flame
Berkshire_Hathaway	/award/ranked_item/appears_in_ranked_lists./award/ranking/list	Fortune_1000
An_Inconvenient_Truth	/film/film/release_date_s./film/film_regional_release_date/film_release_region	Spain
Maura_Tierney	/award/award_nominee/award_nominations./award/award_nomination/award	Screen_Actors_Guild_Award_for_Outstanding_Performance_by_an_Ensemble_in_a_Drama_Series
Emir_Kusturica	/award/award_nominee/award_nominations./award/award_nomination/award	Academy_Award_for_Best_Foreign_Language_Film
Amber_Benson	/people/person/profession	Screenwriter
Evangelion:_2.0_You_Can_(Not)_Advance	/film/film/language	Japanese_Language
South_Park:_Bigger,_Longer_&_Uncut	/film/film/genre	Political_cinema
Hugh_Hefner	/common/topic/webpage./common/webpage/category	Official_Website
Kate_Nelligan	/award/award_nominee/award_nominations./award/award_nomination/award	Tony_Award_for_Best_Featured_Actress_in_a_Play
Battleship	/film/film/release_date_s./film/film_regional_release_date/film_release_region	Paraguay
Jackass:_The_Movie	/film/film/release_date_s./film/film_regional_release_date/film_release_distribution_medium	DVD
Mel_Brooks	/award/award_nominee/award_nominations./award/award_nomination/award	Golden_Globe_Award_for_Best_Original_Song
Vice_President-GB	/business/job_title/people_with_this_title./business/employment_tenure/company	American_International_Group
Vice_President-GB	/business/job_title/people_with_this_title./business/employment_tenure/company	Target_Corporation
The_Wolfman	/film/film/release_date_s./film/film_regional_release_date/film_release_region	Norway
29th_Academy_Awards	/time/event/instance_of_recurring_event	Academy_Awards
David_Hasselhoff	/common/topic/webpage./common/webpage/category	Official_Website
Eugene_Levy	/film/actor/film./film/performance/film	American_Reunion
Pruritus	/medicine/symptom/symptom_of	Chronic_kidney_disease
Treat_Williams	/people/person/places_lived./people/place_lived/location	Norwalk
Experimental_metal	/music/genre/artists	Gwar
Harlan_Ellison	/award/award_nominee/award_nominations./award/award_nomination/award	Prometheus_Hall_of_Fame_Award
Arthur_C._Clarke_Award	/award/award_category/disciplines_or_subjects	Science_Fiction
Angel	/tv/tv_program/languages	English_Language
The_Expendables_2	/film/film/release_date_s./film/film_regional_release_date/film_regional_debut_venue	Paris
James_Remar	/award/award_nominee/award_nominations./award/award_nomination/award_nominee	Jennifer_Carpenter
The_Bridges_of_Madison_County	/film/film/release_date_s./film/film_regional_release_date/film_release_region	Poland
Cedric_the_Entertainer	/people/person/profession	Screenwriter
Andy_Heyward	/people/person/nationality	United_States_of_America
Swimming	/olympics/olympic_sport/athletes./olympics/olympic_athlete_affiliation/country	Republic_of_Macedonia
Swimming	/olympics/olympic_sport/athletes./olympics/olympic_athlete_affiliation/country	Tonga
JPMorgan_Chase	/base/schemastaging/organization_extra/phone_number./base/schemastaging/phone_sandbox/service_location	Puerto_Rico
Roscoe_Arbuckle	/people/person/gender	Male
Tina_Turner	/award/award_nominee/award_nominations./award/award_nomination/award	Grammy_Award_for_Best_Female_R&B_Vocal_Performance
My_Man_Godfrey	/film/film/estimated_budget./measurement_unit/dated_money_value/currency	United_States_Dollar
Big_band	/music/genre/artists	B.B._King
Steve_Martin	/award/award_nominee/award_nominations./award/award_nomination/award	Primetime_Emmy_Award_for_Outstanding_Guest_Actor_-_Comedy_Series
Metro_Detroit	/location/location/contains	Bloomfield_Hills
Stevie_Wonder	/music/group_member/membership./music/group_membership/group	U.S.A._for_Africa
Sam_Trammell	/people/person/place_of_birth	New_Orleans
Grammy_Award_for_Best_R&B_Album	/award/award_category/winners./award/award_honor/ceremony	44th_Annual_Grammy_Awards
Robin_Wright	/award/award_nominee/award_nominations./award/award_nomination/award	Screen_Actors_Guild_Award_for_Outstanding_Performance_by_a_Female_Actor_in_a_Miniseries_or_Television_Movie
Extremely_Loud_and_Incredibly_Close	/film/film/genre	Mystery
Extremely_Loud_and_Incredibly_Close	/film/film/release_date_s./film/film_regional_release_date/film_release_region	France
Treviso	/location/location/time_zones	Central_European_Time_Zone-US
Classical_music	/music/genre/artists	Aretha_Franklin
Academy_Award_for_Best_Makeup_and_Hairstyling	/award/award_category/nominees./award/award_nomination/nominated_for	Pirates_of_the_Caribbean:_At_World's_End
Primetime_Emmy_Award_for_Outstanding_Guest_Actress_-_Comedy_Series	/award/award_category/category_of	Primetime_Emmy_Award
National_Board_of_Review_Award_for_Best_Director	/award/award_category/winners./award/award_honor/award_winner	Martin_Scorsese
Pulp_Fiction	/film/film/genre	Indie_film
Gene_Hackman	/people/person/languages	English_Language
Rockstar_Games	/business/business_operation/industry	Video_game
Newsreader-GB	/business/job_title/people_with_this_title./business/employment_tenure/company	British_Broadcasting_Corporation
Grammy_Award_for_Best_Contemporary_R&B_Gospel_Album	/award/award_category/winners./award/award_honor/ceremony	42nd_Annual_Grammy_Awards
Prince_of_Persia:_The_Sands_of_Time	/film/film/language	English_Language
American_Beauty	/film/film/film_festivals	2010_Toronto_International_Film_Festival
Oprah_Winfrey	/people/person/profession	Television_producer-GB
BAFTA_Award_for_Best_Film	/award/award_category/nominees./award/award_nomination/nominated_for	Rear_Window
BAFTA_Award_for_Best_Film	/award/award_category/nominees./award/award_nomination/nominated_for	Shrek
Neal_H._Moritz	/people/person/place_of_birth	Los_Angeles
World_War_II	/film/film_subject/films	The_Remains_of_the_Day
Curtis_Hanson	/film/actor/film./film/performance/film	Adaptation
Kingdom_of_Heaven	/film/film/country	United_Kingdom
Brian_Drummond	/film/actor/dubbing_performances./film/dubbing_performance/language	English_Language
Murder_by_Decree	/film/film/genre	Horror
Murder_by_Decree	/film/film/release_date_s./film/film_regional_release_date/film_release_region	United_States_of_America
Star_Wars_Episode_II:_Attack_of_the_Clones	/film/film/other_crew./film/film_crew_gig/film_crew_role	Makeup_Artist-GB
Juris_Doctor	/education/educational_degree/people_with_this_degree./education/education/institution	University_of_Arkansas
William_Cameron_Menzies	/people/person/place_of_birth	New_Haven
James_Spader	/people/person/nationality	United_States_of_America
Footloose	/film/film/release_date_s./film/film_regional_release_date/film_release_region	Republic_of_Ireland
Musician-GB	/tv/non_character_role/tv_regular_personal_appearances./tv/tv_regular_personal_appearance/person	Itzhak_Perlman
Anonymous	/film/film/other_crew./film/film_crew_gig/film_crew_role	Special_Effects_Supervisor
WALL-E	/film/film/featured_film_locations	New_York_City
Shakti_Kapoor	/people/person/nationality	India
Peter_Gabriel	/people/person/gender	Male
Peter_Gabriel	/people/person/places_lived./people/place_lived/location	Bath
The_Proposal	/film/film/release_date_s./film/film_regional_release_date/film_release_region	Poland
6th_Screen_Actors_Guild_Awards	/award/award_ceremony/awards_presented./award/award_honor/award_winner	Dominic_Chianese
House	/tv/tv_program/genre	Drama
40th_Academy_Awards	/time/event/locations	Los_Angeles
The_Tourist	/film/film/produced_by	Gary_Barber
Ricky_Gervais	/people/person/gender	Male
Rob_Corddry	/film/actor/film./film/performance/film	Seeking_a_Friend_for_the_End_of_the_World
Yuvan_Shankar_Raja	/people/person/profession	Record_producer-GB
Saw_VII	/film/film/other_crew./film/film_crew_gig/film_crew_role	Graphic_Designer-GB
The_Daily_Show	/tv/tv_program/languages	English_Language
Michelle_Pfeiffer	/film/actor/film./film/performance/film	What_Lies_Beneath
Grown_Ups	/film/film/other_crew./film/film_crew_gig/film_crew_role	Sound_Mixer
BAFTA_Award_for_Best_Film_Music	/award/award_category/nominees./award/award_nomination/nominated_for	Four_Weddings_and_a_Funeral
University_of_Hamburg	/education/educational_institution/students_graduates./education/education/major_field_of_study	Economics
South_Sudan	/base/aareas/schema/administrative_area/administrative_area_type	Sovereign_state
Rambo	/film/film/country	Germany
Don_Johnson	/people/person/nationality	United_States_of_America
Steven_Soderbergh	/award/award_nominee/award_nominations./award/award_nomination/award	Golden_Globe_Award_for_Best_Director_-_Motion_Picture
Alan_Cumming	/award/award_nominee/award_nominations./award/award_nomination/award	Independent_Spirit_Award_for_Best_First_Screenplay
Illinois_State_University	/education/educational_institution/students_graduates./education/education/student	Craig_Robinson
Artistic_gymnastics	/olympics/olympic_sport/athletes./olympics/olympic_athlete_affiliation/country	Slovenia
Outfielder	/sports/sports_position/players./sports/sports_team_roster/team	Boston_Red_Sox
Paul_Reubens	/award/award_nominee/award_nominations./award/award_nomination/nominated_for	Murphy_Brown
Oberlin_College	/education/educational_institution/students_graduates./education/education/student	William_Goldman
Friz_Freleng	/people/person/profession	Screenwriter
Jeremy_Northam	/people/person/profession	Actor-GB
Charles_Cornwallis,_1st_Marquess_Cornwallis	/government/politician/government_positions_held./government/government_position_held/jurisdiction_of_office	British_Raj
Switzerland	/olympics/olympic_participating_country/medals_won./olympics/olympic_medal_honor/olympics	1984_Winter_Olympics
William_James	/people/person/nationality	United_States_of_America
27th_United_States_Congress	/government/legislative_session/members./government/government_position_held/district_represented	Missouri
Elite_Squad:_The_Enemy_Within	/film/film/release_date_s./film/film_regional_release_date/film_release_region	Portugal
Trevor_Rabin	/common/topic/webpage./common/webpage/category	Official_Website
The_Crying_Game	/film/film/release_date_s./film/film_regional_release_date/film_release_region	Argentina
Adrien_Brody	/film/actor/film./film/performance/film	The_Thin_Red_Line
Russell_Crowe	/award/award_nominee/award_nominations./award/award_nomination/award	Screen_Actors_Guild_Award_for_Outstanding_Performance_by_a_Cast_in_a_Motion_Picture
California	/location/location/contains	Fremont
Paul_Soloway	/people/person/gender	Male
Tony_Walton	/people/person/profession	Art_Director
Bolt	/film/film/release_date_s./film/film_regional_release_date/film_release_region	United_Kingdom
Diana_Wynne_Jones	/people/person/profession	Writer-GB
Scarborough	/location/location/time_zones	Eastern_Time_Zone
Haywire	/film/film/release_date_s./film/film_regional_release_date/film_release_region	Ireland
Post-punk	/music/genre/artists	The_Flaming_Lips
Pop_music	/music/genre/artists	Pritam_Chakraborty
The_Chronicles_of_Narnia:_Prince_Caspian	/film/film/other_crew./film/film_crew_gig/film_crew_role	Visual_Effects
City_University_of_New_York	/education/educational_institution/school_type	Public_university
Akshay_Kumar	/award/award_nominee/award_nominations./award/award_nomination/award	Filmfare_Award_for_Best_Supporting_Actor
IFC_Films	/film/film_distributor/films_distributed./film/film_film_distributor_relationship/film	The_Good,_the_Bad,_the_Weird
Alexander	/film/film/language	English_Language
Steven_Tyler	/base/schemastaging/person_extra/net_worth./measurement_unit/dated_money_value/currency	United_States_Dollar
James_Mason	/people/deceased_person/place_of_death	Lausanne
University_of_Washington	/education/educational_institution/students_graduates./education/education/major_field_of_study	Computer_Science
University_of_Oklahoma	/education/educational_institution/students_graduates./education/education/major_field_of_study	Journalism
Andrew_Jackson	/government/politician/government_positions_held./government/government_position_held/basic_title	President
Ralph_E._Winters	/people/person/gender	Male
Joe_Pantoliano	/people/person/place_of_birth	Hoboken
Samuel_M._Comer	/people/person/gender	Male
Chris_Cornell	/award/award_nominee/award_nominations./award/award_nomination/nominated_for	Casino_Royale
Omaha	/location/location/time_zones	Central_Time_Zone
2005_NCAA_Men's_Division_I_Basketball_Tournament	/base/marchmadness/ncaa_basketball_tournament/seeds./base/marchmadness/ncaa_tournament_seed/team	LSU_Tigers_men's_basketball
Photography	/education/field_of_study/students_majoring./education/education/major_field_of_study	Psychology
Breaking_and_Entering	/film/film/music	Gabriel_Yared
Independent_Spirit_Award_for_Best_Screenplay	/award/award_category/nominees./award/award_nomination/nominated_for	Mrs._Parker_and_the_Vicious_Circle
EX_Machina	/film/film/release_date_s./film/film_regional_release_date/film_release_distribution_medium	DVD
The_Dark_Knight_Rises	/film/film/costume_design_by	Lindy_Hemming
Vibraphone	/music/performance_role/regular_performances./music/group_membership/role	Baritone
Michael_Dobson	/people/person/nationality	Canada
Greece_national_football_team	/base/x2010fifaworldcupsouthafrica/world_cup_squad/current_world_cup_squad./base/x2010fifaworldcupsouthafrica/current_world_cup_squad/current_club	Celtic_F.C.
Oregon	/location/statistical_region/religions./location/religion_percentage/religion	United_Church_of_Christ
Four_Weddings_and_a_Funeral	/award/award_winning_work/awards_won./award/award_honor/award	BAFTA_Award_for_Best_Direction
Iraq	/location/country/form_of_government	Parliamentary_system
Connecticut	/location/statistical_region/religions./location/religion_percentage/religion	United_Church_of_Christ
Manchester_Monarchs	/sports/sports_team/colors	Gold
Saturday_Night's_Main_Event	/tv/tv_program/country_of_origin	United_States_of_America
18th_United_States_Congress	/government/legislative_session/members./government/government_position_held/district_represented	Maryland
Lost_Highway	/film/film/release_date_s./film/film_regional_release_date/film_release_region	Singapore
Tim_Curry	/film/actor/film./film/performance/film	Kinsey
Arkansas	/location/location/contains	Hot_Springs
Dublin	/travel/travel_destination/climate./travel/travel_destination_monthly_climate/month	October
All_the_President's_Men	/film/film/runtime./film/film_cut/film_release_region	Spain
University_of_Toronto	/education/educational_institution/students_graduates./education/education/major_field_of_study	Engineering-GB
David_Ogden_Stiers	/award/award_nominee/award_nominations./award/award_nomination/award	Primetime_Emmy_Award_for_Outstanding_Supporting_Actor_-_Comedy_Series
Addams_Family_Values	/film/film/genre	Black_comedy
Alec_Guinness	/people/person/languages	English_Language
Grey's_Anatomy	/common/topic/webpage./common/webpage/category	Official_Website
Spartacus	/film/film/release_date_s./film/film_regional_release_date/film_release_region	Japan
Robert_Downey_Jr.	/people/person/places_lived./people/place_lived/location	New_York_City
The_Help	/award/award_winning_work/awards_won./award/award_honor/award	National_Board_of_Review_Award_for_Best_Cast
Scottish_American	/people/ethnicity/people	Joseph_Campbell
Scottish_American	/people/ethnicity/people	John_Paul_Jones
Lynyrd_Skynyrd	/common/topic/webpage./common/webpage/category	Official_Website
Writers_Guild_of_America_Awards_2007	/award/award_ceremony/awards_presented./award/award_honor/honored_for	30_Rock
Chris_Parnell	/people/person/profession	Musician-GB
Carnage	/film/film/release_date_s./film/film_regional_release_date/film_release_region	Croatia
Jules_Dassin	/people/deceased_person/place_of_death	Athens
Political_thriller	/media_common/netflix_genre/titles	State_of_Play
New_Jersey	/location/location/contains	Bergen_County
Pat_Benatar	/award/award_nominee/award_nominations./award/award_nomination/award	MTV_Video_Music_Award_for_Best_Female_Video
Irish_American	/people/ethnicity/people	Bo_Derek
Viola	/music/instrument/instrumentalists	John_Cale
San_Diego	/sports/sports_team_location/teams	San_Diego_Padres
Jaws_3-D	/film/film/release_date_s./film/film_regional_release_date/film_release_region	Australia
Jaws_3-D	/film/film/release_date_s./film/film_regional_release_date/film_release_region	Netherlands
Jazz	/music/genre/artists	Ray_Manzarek
Burt_Lancaster	/people/person/spouse_s./people/marriage/type_of_union	Marriage
Comedy-GB	/media_common/netflix_genre/titles	Rush_Hour_3
Live_and_Let_Die	/film/film/language	English_Language
Paterson	/location/hud_foreclosure_area/estimated_number_of_mortgages./measurement_unit/dated_integer/source	United_States_Department_of_Housing_and_Urban_Development
Batman_Begins	/film/film/release_date_s./film/film_regional_release_date/film_release_region	Portugal
Nine_Lives	/film/film/country	United_States_of_America
Charlotte_Gainsbourg	/people/person/nationality	England
Charlotte_Gainsbourg	/people/person/place_of_birth	London
Orange_County	/location/statistical_region/rent50_2./measurement_unit/dated_money_value/currency	United_States_Dollar
Tak_Fujimoto	/award/award_nominee/award_nominations./award/award_nomination/award	Satellite_Award_for_Best_Cinematography
Juhi_Chawla	/people/person/profession	Voice_Actor
ADO_Den_Haag	/common/topic/webpage./common/webpage/category	Official_Website
Keira_Knightley	/film/actor/film./film/performance/film	Seeking_a_Friend_for_the_End_of_the_World
Cowboys_&_Aliens	/film/film/release_date_s./film/film_regional_release_date/film_release_region	Argentina
Dolph_Lundgren	/film/actor/film./film/performance/film	A_View_to_a_Kill
The_Cleveland_Show	/tv/tv_program/regular_cast./tv/regular_tv_appearance/actor	Jason_Sudeikis
Last_of_the_Summer_Wine	/tv/tv_program/regular_cast./tv/regular_tv_appearance/actor	John_Cleese
Helena_Bonham_Carter	/award/award_nominee/award_nominations./award/award_nomination/award	Primetime_Emmy_Award_for_Outstanding_Supporting_Actress_-_Miniseries_or_a_Movie
The_Dreamers	/film/film/release_date_s./film/film_regional_release_date/film_release_region	Brazil
The_Dreamers	/film/film/release_date_s./film/film_regional_release_date/film_release_region	Argentina
Tom_Hanks	/film/actor/film./film/performance/film	Toy_Story_3
Cee_Lo_Green	/award/award_nominee/award_nominations./award/award_nomination/award	Grammy_Award_for_Song_of_the_Year
Hellboy	/film/film/release_date_s./film/film_regional_release_date/film_release_region	Brazil
Prince	/award/award_nominee/award_nominations./award/award_nomination/award	Academy_Award_for_Best_Original_Musical
How_to_Train_Your_Dragon	/film/film/estimated_budget./measurement_unit/dated_money_value/currency	United_States_Dollar
England_national_football_team	/base/x2010fifaworldcupsouthafrica/world_cup_squad/current_world_cup_squad./base/x2010fifaworldcupsouthafrica/current_world_cup_squad/current_club	Tottenham_Hotspur_F.C.
Grammy_Award_for_Best_Recording_Package	/award/award_category/category_of	Grammy_Awards
Grammy_Award_for_Best_Recording_Package	/award/award_category/winners./award/award_honor/ceremony	46th_Annual_Grammy_Awards
The_Towering_Inferno	/film/film/written_by	Stirling_Silliphant
Larry_Mullen,_Jr.	/award/award_nominee/award_nominations./award/award_nomination/award	MTV_Video_Music_Award_for_Best_Video_from_a_Film
New_York_Film_Critics_Circle_Award_for_Best_Film	/award/award_category/winners./award/award_honor/award_winner	Robert_Redford
Steve_Englehart	/common/topic/webpage./common/webpage/category	Official_Website
Nebula_Award_for_Best_Novel	/award/award_category/disciplines_or_subjects	Fiction
The_Reader	/film/film/other_crew./film/film_crew_gig/film_crew_role	Art_Director
National_Society_of_Film_Critics_Award_for_Best_Director	/award/award_category/nominees./award/award_nomination/nominated_for	Sideways
Track_cycling	/olympics/olympic_sport/athletes./olympics/olympic_athlete_affiliation/olympics	2008_Summer_Olympics
Television_Hall_of_Fame	/award/hall_of_fame/inductees./award/hall_of_fame_induction/inductee	Jack_Webb
Television_Hall_of_Fame	/award/hall_of_fame/inductees./award/hall_of_fame_induction/inductee	James_Burrows
Television_Hall_of_Fame	/award/hall_of_fame/inductees./award/hall_of_fame_induction/inductee	Betty_White
Alison_Krauss	/award/award_nominee/award_nominations./award/award_nomination/award	Grammy_Award_for_Best_Contemporary_Folk_Album
Karl_Urban	/people/person/spouse_s./people/marriage/type_of_union	Marriage
The_Proposition	/film/film/country	United_Kingdom
Patton_Oswalt	/people/person/nationality	United_States_of_America
Beetlejuice	/film/film/other_crew./film/film_crew_gig/film_crew_role	Makeup_Artist-GB
John_Williams	/base/schemastaging/person_extra/net_worth./measurement_unit/dated_money_value/currency	United_States_Dollar
Academy_Award_for_Best_Actor_in_a_Supporting_Role	/award/award_category/nominees./award/award_nomination/nominated_for	Raging_Bull
Nirvana	/influence/influence_node/influenced_by	Pixies
Van_Johnson	/people/person/nationality	United_States_of_America
The_Lost_World:_Jurassic_Park	/film/film/genre	Action_Film
Fantastic_Four	/film/film/estimated_budget./measurement_unit/dated_money_value/currency	United_States_Dollar
Eddie_Murphy	/people/person/languages	English_Language
The_Poseidon_Adventure	/film/film/genre	Thriller
26th_United_States_Congress	/government/legislative_session/members./government/government_position_held/district_represented	Delaware
Billy_Joel	/award/award_nominee/award_nominations./award/award_nomination/award	MTV_Video_Music_Award_for_Best_Art_Direction
Aya_Hisakawa	/film/actor/film./film/performance/film	Bleach:_The_DiamondDust_Rebellion
The_Merry_Widow	/film/film/release_date_s./film/film_regional_release_date/film_release_region	Turkey
Canada	/location/location/contains	Charlottetown
The_History_Boys	/film/film/production_companies	Fox_Searchlight_Pictures
Diane_Lane	/award/award_nominee/award_nominations./award/award_nomination/award	Primetime_Emmy_Award_for_Outstanding_Lead_Actress_-_Miniseries_or_a_Movie
House_of_Flying_Daggers	/film/film/release_date_s./film/film_regional_release_date/film_release_region	South_Korea
Germany	/sports/sports_team_location/teams	Germany_national_football_team
Tom_Morello	/people/person/spouse_s./people/marriage/type_of_union	Marriage
The_Hunchback_of_Notre_Dame	/film/film/other_crew./film/film_crew_gig/film_crew_role	Visual_Effects
Dark_cabaret	/music/genre/artists	Tori_Amos
In_America	/film/film/release_date_s./film/film_regional_release_date/film_release_region	United_States_of_America
56th_Primetime_Emmy_Awards	/award/award_ceremony/awards_presented./award/award_honor/award_winner	David_Hyde_Pierce
Madurai	/common/topic/webpage./common/webpage/category	Official_Website
The_Wings_of_the_Dove	/film/film/executive_produced_by	Harvey_Weinstein
A_Prophet	/film/film/film_format	35_mm_film
Bad_Teacher	/film/film/release_date_s./film/film_regional_release_date/film_release_region	Turkey
X-Men_Origins:_Wolverine	/film/film/executive_produced_by	Stan_Lee
Big_Fish	/film/film/featured_film_locations	Montgomery
Big_Fish	/film/film/release_date_s./film/film_regional_release_date/film_release_region	Argentina
Peter_Cullen	/film/actor/film./film/performance/film	Mickey's_Magical_Christmas:_Snowed_in_at_the_House_of_Mouse
Louise_Fletcher	/award/award_nominee/award_nominations./award/award_nomination/nominated_for	Picket_Fences
United_States_of_America	/location/location/contains	San_Diego_State_University
United_States_of_America	/location/location/contains	Plymouth
United_States_of_America	/location/country/second_level_divisions	Niagara_County
Mick_Harvey	/music/artist/track_contributions./music/track_contribution/role	Saxophone
Lou_Diamond_Phillips	/people/person/gender	Male
Stephen_King	/influence/influence_node/influenced_by	Bram_Stoker
Playboy_Playmate	/award/award_category/winners./award/award_honor/award_winner	Marilyn_Monroe
Guitar	/music/instrument/instrumentalists	k.d._lang
Guitar	/music/instrument/instrumentalists	Chad_Smith
Bernie	/film/film/release_date_s./film/film_regional_release_date/film_release_region	Iceland
Judo	/olympics/olympic_sport/athletes./olympics/olympic_athlete_affiliation/country	Philippines
Judo	/olympics/olympic_sport/athletes./olympics/olympic_athlete_affiliation/country	Canada
Ernie_Hudson	/people/person/profession	Film_Producer-GB
Clive_A._Smith	/tv/tv_producer/programs_produced./tv/tv_producer_term/producer_type	Executive_Producer
David_Lee	/people/person/profession	Television_producer-GB
Bank_of_America_Corporation	/base/schemastaging/organization_extra/phone_number./base/schemastaging/phone_sandbox/contact_category	Customer_service
Tamil	/people/ethnicity/people	Nassar
Bobby_McFerrin	/people/person/profession	Songwriter-GB
Emma_Thompson	/award/award_nominee/award_nominations./award/award_nomination/award	British_Independent_Film_Award_for_Best_Actress
University_of_California,_Santa_Barbara	/education/educational_institution/students_graduates./education/education/student	Michael_Douglas
Pacific_Palisades	/base/biblioness/bibs_location/country	United_States_of_America
Tony_Award_for_Best_Featured_Actor_in_a_Play	/award/award_category/winners./award/award_honor/award_winner	Roddy_McDowall
Lauren_Holly	/award/award_nominee/award_nominations./award/award_nomination/award_nominee	Fyvush_Finkel
Goalkeeper	/sports/sports_position/players./sports/sports_team_roster/team	Brentford_F.C.
Michael_W._Smith	/people/person/spouse_s./people/marriage/type_of_union	Marriage
Captain_Corelli's_Mandolin	/film/film/other_crew./film/film_crew_gig/film_crew_role	Special_Effects
Princeton_University	/award/ranked_item/appears_in_ranked_lists./award/ranking/list	Times_Higher_Education_World_University_Rankings
Mary_McCormack	/award/award_nominee/award_nominations./award/award_nomination/nominated_for	The_West_Wing
46th_Academy_Awards	/award/award_ceremony/awards_presented./award/award_honor/award_winner	John_Houseman
Elisabeth_Shue	/film/actor/film./film/performance/film	Deconstructing_Harry
Academy_Award_for_Best_Cinematography	/award/award_category/nominees./award/award_nomination/nominated_for	The_Heiress
Dancehall	/music/genre/artists	Grace_Jones
69th_Golden_Globe_Awards	/award/award_ceremony/awards_presented./award/award_honor/award_winner	Kelsey_Grammer
The_Golden_Compass	/film/film/language	French_Language
20th-century_classical_music	/music/genre/artists	Benjamin_Britten
Jennifer_Connelly	/award/award_nominee/award_nominations./award/award_nomination/award	Independent_Spirit_Award_for_Best_Supporting_Female
Toy_Story_3	/film/film/estimated_budget./measurement_unit/dated_money_value/currency	United_States_Dollar
Toy_Story_3	/film/film/release_date_s./film/film_regional_release_date/film_release_distribution_medium	Blu-ray_disc
Richard_Harris	/people/person/profession	Writer-GB
Noel_Gallagher	/people/person/profession	Guitarist-GB
Vivendi	/award/ranked_item/appears_in_ranked_lists./award/ranking/list	Fortune_Global_500
2K_Games	/base/schemastaging/organization_extra/phone_number./base/schemastaging/phone_sandbox/service_location	Netherlands
Catherine_Keener	/people/person/places_lived./people/place_lived/location	Los_Angeles
Donald_M._Payne	/government/politician/government_positions_held./government/government_position_held/legislative_sessions	111th_United_States_Congress
Donald_M._Payne	/government/politician/government_positions_held./government/government_position_held/legislative_sessions	102nd_United_States_Congress
Taiwan	/base/aareas/schema/administrative_area/administrative_parent	Earth
Academy_Award_for_Best_Writing_Adapted_Screenplay	/award/award_category/nominees./award/award_nomination/nominated_for	Terms_of_Endearment
Academy_Award_for_Best_Writing_Adapted_Screenplay	/award/award_category/nominees./award/award_nomination/nominated_for	Sophie's_Choice
Academy_Award_for_Best_Writing_Adapted_Screenplay	/award/award_category/winners./award/award_honor/ceremony	41st_Academy_Awards
World_Trade_Organization	/common/topic/webpage./common/webpage/category	Official_Website
Friedrich_Schiller	/people/person/profession	Writer-GB
Wayne_Shorter	/people/person/gender	Male
Jerry_Belson	/award/award_nominee/award_nominations./award/award_nomination/award	Primetime_Emmy_Award_for_Outstanding_Comedy_Series
Priyadarshan	/people/person/profession	Film_Director
Governor-GB	/government/government_office_category/officeholders./government/government_position_held/jurisdiction_of_office	Shizuoka_Prefecture
17th_Screen_Actors_Guild_Awards	/award/award_ceremony/awards_presented./award/award_honor/award_winner	Gretchen_Mol
North_America-US	/base/locations/continents/countries_within	Saint_Kitts_and_Nevis
Mrs._Miniver	/award/ranked_item/appears_in_ranked_lists./award/ranking/list	National_Film_Registry
Drew_Goddard	/tv/tv_writer/tv_programs./tv/tv_program_writer_relationship/tv_program	Buffy_the_Vampire_Slayer
Metro-Goldwyn-Mayer	/film/film_distributor/films_distributed./film/film_film_distributor_relationship/film	The_Guns_of_Navarone
67th_Golden_Globe_Awards	/award/award_ceremony/awards_presented./award/award_honor/award_winner	James_Cameron
Bandai_Namco_Holdings	/organization/organization/headquarters./location/mailing_address/state_province_region	Tokyo
David_Hemmings	/film/actor/film./film/performance/film	Gladiator
Jay_Bennett	/people/person/profession	Guitarist-GB
Lara_Flynn_Boyle	/film/actor/film./film/performance/film	Wayne's_World
Norah_Jones	/music/artist/track_contributions./music/track_contribution/role	Guitar
Peabody_Award	/award/award_category/winners./award/award_honor/award_winner	Xerox
Joshua_Jackson	/award/award_nominee/award_nominations./award/award_nomination/award_nominee	Elijah_Wood
Nicaragua	/location/country/form_of_government	Unitary_state
Toy_Story	/film/film/release_date_s./film/film_regional_release_date/film_release_region	Sweden
Iowa_State_University	/education/educational_institution/students_graduates./education/education/major_field_of_study	Aerospace_Engineering-GB
American_History_X	/film/film/distributors./film/film_film_distributor_relationship/film_distribution_medium	Streaming_media
The_Last_Song	/film/film/other_crew./film/film_crew_gig/film_crew_role	Visual_Effects_Supervisor
This_Is_England	/film/film/release_date_s./film/film_regional_release_date/film_release_region	Spain
Simply_Red	/music/artist/origin	Manchester
Ottawa	/sports/sports_team_location/teams	Ottawa_Senators
England	/location/location/contains	London
Betty_Grable	/people/person/nationality	United_States_of_America
Jessica_Lange	/people/person/spouse_s./people/marriage/type_of_union	Domestic_partnership
Prime_minister-GB	/government/government_office_category/officeholders./government/government_position_held/jurisdiction_of_office	Niger
Skeleton	/olympics/olympic_sport/athletes./olympics/olympic_athlete_affiliation/country	Austria
Patti_Smith	/music/group_member/membership./music/group_membership/group	Blondie
David_Cross	/film/actor/film./film/performance/film	Scary_Movie_2
Antioch_College	/education/educational_institution/students_graduates./education/education/major_field_of_study	Music
Bates_College	/education/educational_institution/students_graduates./education/education/major_field_of_study	Mathematics
Octavia_Spencer	/people/person/profession	Actor-GB
Corey_Feldman	/people/person/places_lived./people/place_lived/location	Encino
Doom_metal	/music/genre/artists	Glenn_Danzig
Nome_Census_Area	/base/aareas/schema/administrative_area/administrative_parent	Alaska
The_Piano	/award/award_winning_work/awards_won./award/award_honor/award	New_York_Film_Critics_Circle_Award_for_Best_Actress
Shimizu_S-Pulse	/soccer/football_team/current_roster./soccer/football_roster_position/position	Defender
Steven_Bauer	/people/person/places_lived./people/place_lived/location	Miami
Film_score	/music/genre/artists	Milt_Franklyn
Tennessee_Williams	/people/person/profession	Writer-GB
20th_Century_Fox	/film/film_distributor/films_distributed./film/film_film_distributor_relationship/film	The_Towering_Inferno
Emile_Hirsch	/award/award_nominee/award_nominations./award/award_nomination/award	Broadcast_Film_Critics_Association_Award_for_Best_Actor
Richard_Rorty	/influence/influence_node/influenced_by	Jacques_Derrida
ANTIâ	/music/record_label/artist	Nick_Cave_and_the_Bad_Seeds
Bill_Fagerbakke	/people/person/nationality	United_States_of_America
Dan_Aykroyd	/people/person/spouse_s./people/marriage/type_of_union	Marriage
Lost	/tv/tv_program/genre	Drama
Republic_of_Venice	/location/country/capital	Venice
Mark_Tinker	/people/person/gender	Male
Screen_Actors_Guild_Award_for_Outstanding_Performance_by_an_Ensemble_in_a_Comedy_Series	/award/award_category/winners./award/award_honor/award_winner	Ariel_Winter
The_Music_Man	/film/film/release_date_s./film/film_regional_release_date/film_release_region	Finland
Ben_Folds	/people/person/profession	Keyboard_player-GB
The_Prodigy	/award/award_nominee/award_nominations./award/award_nomination/award	MTV_Video_Music_Award_for_Best_Editing
Alan_Parsons	/music/artist/track_contributions./music/track_contribution/role	pipe_organ
Rich_Little	/base/americancomedy/celebrity_impressionist/celebrities_impersonated	Michael_Caine
Anthony_Minghella	/award/award_nominee/award_nominations./award/award_nomination/award	Writers_Guild_of_America_Award_for_Best_Adapted_Screenplay
Gulliver's_Travels-GB	/tv/tv_program/regular_cast./tv/regular_tv_appearance/actor	James_Fox
William_Shatner	/award/award_nominee/award_nominations./award/award_nomination/award	Screen_Actors_Guild_Award_for_Outstanding_Performance_by_an_Ensemble_in_a_Comedy_Series
Rome	/travel/travel_destination/climate./travel/travel_destination_monthly_climate/month	June
Bachelor_of_Arts	/education/educational_degree/people_with_this_degree./education/education/institution	University_of_Arizona
Bachelor_of_Arts	/education/educational_degree/people_with_this_degree./education/education/institution	Loyola_Marymount_University
Bachelor_of_Arts	/education/educational_degree/people_with_this_degree./education/education/institution	Australian_National_University
Bachelor_of_Arts	/education/educational_degree/people_with_this_degree./education/education/institution	Case_Western_Reserve_University
Bachelor_of_Arts	/education/educational_degree/people_with_this_degree./education/education/institution	University_of_Cape_Town
Katie_Couric	/people/person/place_of_birth	Arlington_County
American_Graffiti	/film/film/release_date_s./film/film_regional_release_date/film_release_region	Sweden
Americas	/location/location/contains	Barbados
Contiguous_United_States	/location/location/time_zones	Central_Time_Zone
Colorado_Rockies	/sports/professional_sports_team/draft_picks./sports/sports_league_draft_pick/school	University_of_Tennessee
Wreck-It_Ralph	/film/film/release_date_s./film/film_regional_release_date/film_release_region	Spain
Wreck-It_Ralph	/film/film/release_date_s./film/film_regional_release_date/film_release_region	Finland
Chinese_American	/people/ethnicity/languages_spoken	Mandarin_Chinese
Academy_Award_for_Best_Original_Music_Score	/award/award_category/nominees./award/award_nomination/nominated_for	Interview_with_the_Vampire:_The_Vampire_Chronicles
Beau_Bridges	/award/award_nominee/award_nominations./award/award_nomination/nominated_for	Brothers_&_Sisters
Young_Adam	/film/film/release_date_s./film/film_regional_release_date/film_release_region	Hungary
Bread	/food/food/nutrients./food/nutrition_fact/nutrient	Aspartic_acid
Jenny_McCarthy	/people/person/spouse_s./people/marriage/type_of_union	Marriage
Barry_Pepper	/film/actor/film./film/performance/film	Flags_of_Our_Fathers
Reversal_of_Fortune	/film/film/language	English_Language
Rock_music	/music/genre/artists	Toto
Rock_music	/music/genre/artists	Trevor_Horn
Rock_music	/music/genre/artists	Noel_Gallagher
Jared_Harris	/film/actor/film./film/performance/film	I_Shot_Andy_Warhol
John_Frusciante	/people/person/gender	Male
Notting_Hill	/film/film/film_format	Super_35
Ted_Kennedy	/government/politician/government_positions_held./government/government_position_held/legislative_sessions	92nd_United_States_Congress
To_Kill_a_Mockingbird	/film/film/release_date_s./film/film_regional_release_date/film_release_region	Switzerland
The_Lord_of_the_Rings:_The_Two_Towers	/film/film/story_by	J._R._R._Tolkien
Rachel_Griffiths	/award/award_nominee/award_nominations./award/award_nomination/award	Primetime_Emmy_Award_for_Outstanding_Continued_Performance_by_an_Actress_in_a_Leading_Role_in_a_Dramatic_Series
Sam_Shepard	/people/person/profession	Actor-GB
Robert_Gates	/people/person/gender	Male
Paul_Oakenfold	/people/person/profession	Record_producer-GB
Infernal_Affairs_II	/film/film/genre	World_cinema
Ohio_State_University	/education/educational_institution/students_graduates./education/education/major_field_of_study	Mechanical_Engineering
Vernon_Chatman	/people/person/place_of_birth	Brooklyn
Brave	/film/film/release_date_s./film/film_regional_release_date/film_release_region	Ukraine
Robert_Smith	/people/person/religion	Catholicism
Northern_Ireland	/location/country/official_language	English_Language
Ed_McMahon	/people/person/places_lived./people/place_lived/location	Massachusetts
What_Dreams_May_Come	/film/film/other_crew./film/film_crew_gig/film_crew_role	Sound_Mixer
Atlanta	/sports/sports_team_location/teams	Atlanta_Hawks
Dorothy_Malone	/people/person/gender	Female
Patrick_Stewart	/award/award_nominee/award_nominations./award/award_nomination/award	Saturn_Award_for_Best_Actor
Patrick_Stewart	/influence/influence_node/influenced_by	Laurence_Olivier
Shopgirl	/film/film/genre	Comedy-GB
Croatian_American	/people/ethnicity/people	Nikola_Tesla
Casablanca_Records	/music/record_label/artist	George_Clinton
Boalt_Hall	/common/topic/webpage./common/webpage/category	Official_Website
David_Thewlis	/people/person/nationality	England
Kelly_Macdonald	/award/award_nominee/award_nominations./award/award_nomination/award_nominee	Clive_Owen
Keyboard	/music/performance_role/regular_performances./music/group_membership/group	Uriah_Heep
Kevin_Nealon	/base/eating/practicer_of_diet/diet	Veganism
Master_of_Science	/education/educational_degree/people_with_this_degree./education/education/major_field_of_study	Philosophy
Master_of_Science	/education/educational_degree/people_with_this_degree./education/education/institution	Duke_University
LL_Cool_J	/people/person/spouse_s./people/marriage/type_of_union	Marriage
Kentucky	/location/location/contains	Louisville
Udinese_Calcio	/sports/sports_team/colors	Black
Robin_Thicke	/award/award_nominee/award_nominations./award/award_nomination/award	MTV_Video_Music_Award_for_Best_Male_Video
Steve_Oedekerk	/people/person/profession	Film_Producer-GB
Brad_Bird	/people/person/profession	Actor-GB
Margaret_Atwood	/people/person/profession	Author-GB
Beginners	/film/film/release_date_s./film/film_regional_release_date/film_release_region	Mexico
James_Poyser	/music/artist/track_contributions./music/track_contribution/role	Celesta
Martie_Maguire	/people/person/profession	Musician-GB
Bachelor_of_Science	/education/educational_degree/people_with_this_degree./education/education/major_field_of_study	Journalism
Bachelor_of_Science	/education/educational_degree/people_with_this_degree./education/education/institution	California_Institute_of_Technology
Star_Wars_Episode_IV:_A_New_Hope	/film/film/production_companies	Lucasfilm
Ted	/film/film/release_date_s./film/film_regional_release_date/film_release_region	France
Michelle_Williams	/award/award_nominee/award_nominations./award/award_nomination/award_nominee	Peter_Dinklage
The_Smurfs	/film/film/other_crew./film/film_crew_gig/film_crew_role	Sound_Mixer
Burt_Young	/award/award_nominee/award_nominations./award/award_nomination/award	Academy_Award_for_Best_Actor_in_a_Supporting_Role
British_people	/people/ethnicity/people	Kenneth_Branagh
British_people	/people/ethnicity/people	David_Watkin
Loyola_University_Chicago	/education/educational_institution/colors	Maroon
Brendan_Coyle	/people/person/nationality	England
Jane_Lynch	/film/actor/film./film/performance/film	Talladega_Nights:_The_Ballad_of_Ricky_Bobby
Batman_Beyond	/tv/tv_program/genre	Animated_series
Jeremy_Piven	/film/actor/film./film/performance/film	Smokin'_Aces
Debi_Mazar	/film/actor/film./film/performance/film	Malcolm_X
Charlie_and_the_Chocolate_Factory	/film/film/genre	Remake
Charlie_and_the_Chocolate_Factory	/film/film/other_crew./film/film_crew_gig/film_crew_role	Special_Effects
Julie_Christie	/people/person/nationality	United_Kingdom
Soft_rock	/music/genre/artists	Paul_Williams
Racewalking	/olympics/olympic_sport/athletes./olympics/olympic_athlete_affiliation/country	South_Africa
The_Adventures_of_Priscilla,_Queen_of_the_Desert	/film/film/country	New_Zealand
The_Man_in_the_Iron_Mask	/film/film/other_crew./film/film_crew_gig/film_crew_role	Special_Effects_Supervisor
Miami_Vice	/film/film/genre	Thriller
Tony_Award_for_Best_Featured_Actor_in_a_Musical	/award/award_category/winners./award/award_honor/ceremony	66th_Tony_Awards
Fred_Quimby	/people/deceased_person/place_of_death	Santa_Monica
Macy_Gray	/award/award_nominee/award_nominations./award/award_nomination/award	MTV_Video_Music_Award_for_Best_Female_Video
Marriage	/people/marriage_union_type/unions_of_this_type./people/marriage/location_of_ceremony	Lebanon
Marriage	/people/marriage_union_type/unions_of_this_type./people/marriage/location_of_ceremony	San_Jose
Marriage	/people/marriage_union_type/unions_of_this_type./people/marriage/location_of_ceremony	County_Kildare
Marriage	/people/marriage_union_type/unions_of_this_type./people/marriage/location_of_ceremony	Newport
Remember_the_Titans	/film/film/production_companies	The_Walt_Disney_Company
Palme_d'Or	/award/award_category/winners./award/award_honor/award_winner	Akira_Kurosawa
Bebe_Neuwirth	/award/award_nominee/award_nominations./award/award_nomination/award	Primetime_Emmy_Award_for_Outstanding_Supporting_Actress_-_Miniseries_or_a_Movie
Denmark-GB	/location/location/time_zones	Central_European_Time_Zone-US
2006_NFL_Draft	/sports/sports_league_draft/picks./sports/sports_league_draft_pick/school	University_of_California,_Los_Angeles
Renny_Harlin	/people/person/profession	Film_Producer-GB
Scottish_people	/people/ethnicity/people	Patrick_Doyle
62nd_Golden_Globe_Awards	/award/award_ceremony/awards_presented./award/award_honor/award_winner	Ian_McShane
Lawless	/film/film/genre	Western
Shame	/film/film/release_date_s./film/film_regional_release_date/film_release_region	United_States_of_America
Jane_Alexander	/award/award_nominee/award_nominations./award/award_nomination/nominated_for	Law_&_Order:_Special_Victims_Unit
Writers_Guild_of_America_Award_for_Best_Adapted_Screenplay	/award/award_category/nominees./award/award_nomination/nominated_for	Julie_&_Julia
Binghamton_University	/education/educational_institution/students_graduates./education/education/major_field_of_study	Political_Science
Fantasy	/media_common/netflix_genre/titles	The_City_of_Lost_Children
Fantasy	/media_common/netflix_genre/titles	The_Lord_of_the_Rings:_The_Return_of_the_King
Allen_Covert	/people/person/profession	Screenwriter
Deleted_scene	/film/special_film_performance_type/film_performance_type./film/performance/film	Dreamgirls
Lauren_Katherine_Conrad	/people/person/profession	Author-GB
Cochin_Haneefa	/people/person/nationality	India
Clifton_Collins,_Jr.	/film/actor/film./film/performance/film	Babel
Ashok_Kumar	/people/person/nationality	India
Michael_McKean	/people/person/profession	Actor-GB
Toronto_Blue_Jays	/sports/professional_sports_team/draft_picks./sports/sports_league_draft_pick/school	California_State_University,_Fresno
Paul_Newman	/people/person/profession	Actor-GB
Ashkenazi_Jews	/people/ethnicity/people	Sigmund_Freud
Raza_Murad	/people/person/gender	Male
Chief_Financial_Officer-GB	/business/job_title/people_with_this_title./business/employment_tenure/company	Clear_Channel_Communications
Never_Say_Never_Again	/film/film/language	English_Language
MTV_Movie_Award_for_Best_Movie	/award/award_category/nominees./award/award_nomination/nominated_for	Saving_Private_Ryan
Modern_pentathlon	/olympics/olympic_sport/athletes./olympics/olympic_athlete_affiliation/country	Kazakhstan
David_Krumholtz	/award/award_nominee/award_nominations./award/award_nomination/award_nominee	William_H._Macy
FC_Rubin_Kazan	/sports/sports_team/colors	Green
Synthesizer	/music/performance_role/regular_performances./music/group_membership/role	Keytar
Alec_Baldwin	/award/award_nominee/award_nominations./award/award_nomination/award	Primetime_Emmy_Award_for_Outstanding_Supporting_Actor_-_Miniseries_or_a_Movie
Sony_Music_Entertainment	/music/record_label/artist	James_Taylor
Inglourious_Basterds	/film/film/release_date_s./film/film_regional_release_date/film_release_region	Slovakia
Country	/music/genre/artists	Chris_Thile
Andy_Richter	/people/person/profession	Comedian
Orlando	/location/location/time_zones	Eastern_Time_Zone
Bruce_Cohen	/people/person/spouse_s./people/marriage/location_of_ceremony	Los_Angeles
Jewish_people	/people/ethnicity/people	Dustin_Hoffman
Columbia_Pictures	/award/award_nominee/award_nominations./award/award_nomination/award_nominee	Allen_Covert
Kurt_Cobain	/influence/influence_node/influenced_by	Sylvia_Plath
The_Namesake	/film/film/other_crew./film/film_crew_gig/film_crew_role	Special_Effects_Supervisor
BAFTA_Award_for_Best_Makeup_&_Hair	/award/award_category/nominees./award/award_nomination/nominated_for	The_Mask
The_Dark_Knight	/film/film/release_date_s./film/film_regional_release_date/film_release_region	New_Zealand
Saturn_Award_for_Best_Costume	/award/award_category/nominees./award/award_nomination/nominated_for	The_Dark_Knight
Osamu_Tezuka	/people/person/profession	Animator-GB
Razzie_Award_for_Worst_Actor	/award/award_category/nominees./award/award_nomination/nominated_for	Flash_Gordon
Thomas_Jefferson	/people/person/profession	Lawyer
Top_Hat	/film/film/genre	Romance_Film
Top_Hat	/film/film/estimated_budget./measurement_unit/dated_money_value/currency	United_States_Dollar
Glen_Morgan	/award/award_nominee/award_nominations./award/award_nomination/award	Primetime_Emmy_Award_for_Outstanding_Drama_Series
Stephanie_Morgenstern	/people/person/place_of_birth	Geneva
Nokia	/base/schemastaging/organization_extra/phone_number./base/schemastaging/phone_sandbox/service_language	Finnish_Language
Elizabeth_McGovern	/award/award_nominee/award_nominations./award/award_nomination/award	Primetime_Emmy_Award_for_Outstanding_Lead_Actress_-_Miniseries_or_a_Movie
G.I._Joe:_The_Rise_of_Cobra	/film/film/other_crew./film/film_crew_gig/film_crew_role	Makeup_Artist-GB
National_Society_of_Film_Critics_Award_for_Best_Supporting_Actress	/award/award_category/nominees./award/award_nomination/nominated_for	2046
Nora_Ephron	/people/person/spouse_s./people/marriage/type_of_union	Marriage
Susan_Sarandon	/film/actor/film./film/performance/film	The_Lovely_Bones
Ukraine	/user/tsegaran/random/taxonomy_subject/entry./user/tsegaran/random/taxonomy_entry/taxonomy	Library_of_Congress_Classification
Billie_Joe_Armstrong	/people/person/gender	Male
Me_and_Orson_Welles	/film/film/other_crew./film/film_crew_gig/film_crew_role	Visual_Effects
Barry_Levinson	/award/award_nominee/award_nominations./award/award_nomination/award_nominee	Robert_De_Niro
Academy_Award_for_Best_Documentary_Feature	/award/award_category/winners./award/award_honor/ceremony	47th_Academy_Awards
Chuck_Jones	/people/person/profession	Animator-GB
Philip_Yordan	/people/deceased_person/place_of_death	La_Jolla
Henri_Matisse	/people/person/gender	Male
Legends_of_the_Fall	/film/film/genre	War_film
Power_pop	/music/genre/artists	Blondie
Peter_Morgan	/people/person/profession	Film_Producer-GB
Quentin_Tarantino	/people/person/profession	Cinematographer-GB
The_Island_Def_Jam_Music_Group	/organization/organization/child./organization/organization_relationship/child	Def_Jam_Recordings
Lung_cancer	/people/cause_of_death/people	Paul_Newman
Rapcore	/music/genre/artists	Adam_Horovitz
The_Wicker_Man	/film/film/release_date_s./film/film_regional_release_date/film_release_distribution_medium	DVD
Ravi_Shankar	/people/person/languages	Bengali_Language
BAFTA_Award_for_Best_Sound	/award/award_category/nominees./award/award_nomination/nominated_for	The_Mission
Grammy_Award_for_Best_New_Artist	/award/award_category/winners./award/award_honor/award_winner	Toni_Braxton
Justin_Theroux	/film/actor/film./film/performance/film	Zoolander
The_Manchurian_Candidate	/film/film/featured_film_locations	New_York_City
Washington_University_in_St._Louis	/education/educational_institution/students_graduates./education/education/student	Harold_Ramis
Lindsay_Lohan	/base/schemastaging/person_extra/net_worth./measurement_unit/dated_money_value/currency	United_States_Dollar
Warner_Bros._Records	/music/record_label/artist	James_Taylor
Warner_Bros._Records	/music/record_label/artist	Devo
Richard_Roxburgh	/award/award_nominee/award_nominations./award/award_nomination/award	Screen_Actors_Guild_Award_for_Outstanding_Performance_by_a_Cast_in_a_Motion_Picture
Jack_Reacher	/film/film/release_date_s./film/film_regional_release_date/film_release_region	Spain
John_Debney	/award/award_nominee/award_nominations./award/award_nomination/nominated_for	The_Scorpion_King
Mike_Leigh	/award/award_nominee/award_nominations./award/award_nomination/award	Satellite_Award_for_Best_Original_Screenplay
Capitol_Records	/music/record_label/artist	Jonny_Greenwood
Frasier	/award/award_winning_work/awards_won./award/award_honor/award	Peabody_Award
Academy_Award_for_Best_Actress	/award/award_category/nominees./award/award_nomination/nominated_for	From_Here_to_Eternity
Carnegie_Mellon_University	/education/educational_institution/students_graduates./education/education/major_field_of_study	Psychology
Carnegie_Mellon_University	/education/educational_institution/students_graduates./education/education/student	Steven_Bochco
Jeff_Goldblum	/award/award_nominee/award_nominations./award/award_nomination/award_nominee	Bill_Murray
Mountain_biking	/olympics/olympic_sport/athletes./olympics/olympic_athlete_affiliation/country	Australia
Eurasia	/location/location/contains	Jersey
Master_of_Arts	/education/educational_degree/people_with_this_degree./education/education/institution	Brandeis_University
Miss_Golden_Globe	/award/award_category/winners./award/award_honor/ceremony	62nd_Golden_Globe_Awards
Grease	/common/topic/webpage./common/webpage/category	Official_Website
Seven_Pounds	/film/film/other_crew./film/film_crew_gig/film_crew_role	Visual_Effects_Supervisor
Geffen_Records	/organization/organization/headquarters./location/mailing_address/citytown	New_York_City
The_Pianist	/film/film/language	German_Language
Dakota_Fanning	/award/award_nominee/award_nominations./award/award_nomination/award_nominee	Kathy_Baker
Percy_Jackson_&_the_Olympians:_The_Lightning_Thief	/film/film/language	Turkish_Language
1936_Summer_Olympics	/olympics/olympic_games/participating_countries	Taiwan
Kansas_City	/base/petbreeds/city_with_dogs/top_breeds./base/petbreeds/dog_city_relationship/dog_breed	Labrador_Retriever
Kansas_City	/location/hud_county_place/place	Kansas_City
University_of_Bonn	/education/university/domestic_tuition./measurement_unit/dated_money_value/currency	Euro
John_Malkovich	/award/award_nominee/award_nominations./award/award_nomination/award	MTV_Movie_Award_for_Best_Villain
Rowing	/olympics/olympic_sport/athletes./olympics/olympic_athlete_affiliation/country	Monaco
Carl_Sagan	/organization/organization_member/member_of./organization/organization_membership/organization	American_Philosophical_Society
Nicole_Kidman	/film/actor/film./film/performance/film	Days_of_Thunder
Victor_Miller	/people/person/profession	Actor-GB
Malta	/organization/organization_member/member_of./organization/organization_membership/organization	World_Bank
What_Lies_Beneath	/film/film/other_crew./film/film_crew_gig/film_crew_role	Visual_Effects_Supervisor
Lorraine_Broderick	/people/person/nationality	United_States_of_America